- vermelho
Alagoas (AL) - Maceió
Bahia (BA) - Salvador
Ceará (CE) - Fortaleza
Distrito Federal (DF) - Brasília
Maranhão (MA) - São Luís
Paraíba (PB) - João Pessoa
Pernambuco (PE) - Recife
Piauí (PI) - Teresina
Rio Grande do Norte (RN) - Natal
Sergipe (SE) - Aracaju

- verde
Amazonas (AM) - Manaus
Acre (AC) - Rio Branco
Rondônia (RO) - Porto Velho
Roraima (RR) - Boa Vista
Pará (PA) - Belém
Amapá (AP) - Macapá
Tocantins (TO) - Palmas

- marrom
Mato Grosso (MT) - Cuiabá
Goiás (GO) - Goiânia
Mato Grosso do Sul (MS) - Campo Grande

- amarelo
São Paulo (SP) - São Paulo
Minas Gerais (MG) - Belo Horizonte
Espírito Santo (ES) - Vitória
Rio de Janeiro (RJ) - Rio de Janeiro

- roxo
Paraná (PR) - Curitiba
Santa Catarina (SC) - Florianópolis
Rio Grande do Sul (RS) - Porto Alegre